{
  "0": ["z", "r"],
  "1": ["b", "c"],
  "2": ["d", "w"],
  "3": ["t", "j"],
  "4": ["f", "q"],
  "5": ["l", "v"],
  "6": ["s", "x"],
  "7": ["p", "m"],
  "8": ["h", "k"],
  "9": ["n", "g"]
}
