{
  "0": ["z", "r"],
  "1": ["b", "c"],
  "2": ["d", "w"],
  "3": ["t"],
  "4": ["f", "q"],
  "5": ["v"],
  "6": ["s", "x"],
  "7": ["p", "m"],
  "8": ["h", "k"],
  "9": ["n"]
}
